F 0,0,255
C 255,13,0
EA ./textures/PIPES_1A.png
NO ./textures/SLIME_1A.png
SO ./textures/SLUDGE_1A.png
WE ./textures/GRID_2B.png

111111111111111
100000100010001
111110101010101
100010101010101
101110101010101
100000101000101
101111101111101
101000000100101
101110111010101
100010100010101
111010111010101
101010001000101
101010111010101
1000001000000N1
111111111111111
