



F 255,0,255
C 0,255,255



EA ./textures/horror_metal_14-512x512.png
NO ./textures/horror_misc_15-512x512.png
SO ./textures/water.png
WE ./textures/metalplates.png

	111111111111
	100000000001
100000000001
100000000001
1000000000011111111111
1000000000000000000001
1001000000011111111111
100W00000001
100000000001
100000000001
100000000001
100000000001
111111111111
