



F 77,92,53
C 163,208,252



EA ./textures/wood.xpm
NO ./textures/greystone.xpm
SO ./textures/purplestone.xpm
WE ./textures/redbrick.xpm


1111111111111111111111111
1000000000000000000000001
10000000000000000000000N1
1111111111111111111111111