



F 77,92,53
C 163,208,252



EA ./textures/wood.xpm
NO ./textures/greystone.xpm
SO ./textures/purplestone.xpm
WE ./textures/redbrick.xpm


1111111111111111111111111
10000000 011000N000000001
1000000000110000000000001
1000000000110000000011111
10000000001100000001
1000000000110000000111111     1111
1111000000110000000000001     1001
    100000110001110000001     1111
1111100000110001 10000001
1000000000110001 10000001
100     00110001 10000001
1000000000110001 10000001
1111111111111111 11111111
