



F 255,0,0
C 0,255,0



EA ./textures/horror_metal_14-512x512.png
NO ./textures/horror_misc_15-512x512.png
SO ./textures/water.png
WE ./textures/metalplates.png


1111111111111111111111111
10000000 011000000000001
1000000000110000000000001
1011000011100000000000001
1001000000000000000000001
11111111101100000111000001
100000000011000001110111111111111
11110111111111011100000010001
11110111111111011101010010001
11000000110101011100000010001
1000000E000000001100000010001
10000000000000001101010010001
11000001110101011111011110 0111
11110111 1110101 101111010001
1111111 1111111 11111 111111
